0 0 0 0 0 0 0 0 0 0 0 0 0 0 0 0
0 1 30 1 1 1 1 1 1 1 1 1 1 1 1 0
0 1 2 7 5 5 5 5 3 3 6 6 7 1 1 0
0 1 5 5 5 2 5 5 6 3 6 6 7 7 1 0
0 1 5 5 5 5 5 5 6 5 6 6 6 6 1 0
0 1 5 5 5 6 5 5 5 3 5 5 5 5 1 0
0 1 5 5 5 2 2 2 5 6 3 3 2 5 1 0
0 1 5 6 6 6 5 20 2 6 5 5 5 2 1 0
0 1 6 7 6 2 2 2 2 2 5 2 2 2 1 0
0 1 6 6 5 5 5 5 5 5 5 5 4 2 1 0
0 1 1 1 1 1 1 1 1 1 1 1 1 1 1 0
0 0 0 0 0 0 0 0 0 0 0 0 0 0 0 0
