0 0 0 0 0 0 0 0 0 0 0 0 0 0 0 0
0 1 30 1 1 1 1 1 1 1 1 1 1 1 1 0
0 1 2 5 2 5 5 5 2 5 6 7 7 1 1 0
0 1 5 5 5 5 5 5 2 5 6 5 7 7 1 0
0 1 6 5 5 5 3 2 5 20 5 5 7 5 1 0
0 1 6 6 6 2 3 5 2 5 5 5 5 5 1 0
0 1 6 6 6 5 3 7 6 6 6 3 5 32 1 0
0 1 5 20 5 5 3 5 2 5 2 6 5 6 1 0
0 1 7 6 7 7 2 7 2 5 2 2 2 6 1 0
0 1 1 6 5 3 5 7 7 2 5 5 4 2 1 0
0 1 1 1 1 1 1 1 1 1 1 1 1 1 1 0
0 0 0 0 0 0 0 0 0 0 0 0 0 0 0 0
