0 0 0 0 0 0 0 0 0 0 0 0 0 0 0 0
0 1 30 1 1 1 1 1 1 1 1 1 1 1 1 0
0 1 2 5 5 5 2 5 5 2 7 7 1 1 1 0
0 1 5 5 5 5 5 5 20 32 5 7 7 8 1 0
0 1 5 5 5 5 5 5 5 3 6 6 6 6 1 0
0 1 5 7 5 5 5 2 2 3 20 2 2 2 1 0
0 1 7 7 8 5 2 2 2 3 3 3 2 8 1 0
0 1 8 8 5 5 8 2 3 8 20 5 2 2 1 0
0 1 8 5 5 8 2 3 3 8 8 8 3 2 1 0
0 1 8 8 5 5 5 5 8 8 8 5 4 2 1 0
0 1 1 1 1 1 1 1 1 1 1 1 1 1 1 0
0 0 0 0 0 0 0 0 0 0 0 0 0 0 0 0
