0 0 0 0 0 0 0 0 0 0 0 0 0 0 0 0
0 1 30 1 1 1 1 1 1 1 1 1 1 1 1 0
0 1 2 5 5 7 7 5 5 2 7 7 1 1 1 0
0 1 5 5 6 5 5 5 5 3 2 7 7 8 1 0
0 1 1 5 5 5 5 7 5 6 6 6 6 6 1 0
0 1 6 5 7 7 7 7 7 7 20 2 31 5 1 0
0 1 3 3 6 5 2 5 5 5 3 3 3 5 1 0
0 1 6 7 7 5 2 5 5 7 20 6 5 5 1 0
0 1 5 7 7 2 2 5 5 7 7 6 3 5 1 0
0 1 8 8 8 8 5 5 3 5 5 5 4 2 1 0
0 1 1 1 1 1 1 1 1 1 1 1 1 1 1 0
0 0 0 0 0 0 0 0 0 0 0 0 0 0 0 0
