0 0 0 0 0 0 0 0 0 0 0 0 0 0 0 0
0 1 30 1 1 1 1 1 1 1 1 1 1 1 1 0
0 1 2 5 5 5 9 9 3 3 9 9 1 1 1 0
0 1 5 5 5 5 9 9 2 3 6 9 9 9 1 0
0 1 5 5 5 5 5 2 2 5 6 6 6 6 1 0
0 1 6 6 3 9 5 2 2 5 20 3 2 2 1 0
0 1 8 8 8 6 7 2 2 5 3 3 4 2 1 0
0 1 9 8 5 6 7 2 2 3 20 3 2 2 1 0
0 1 9 9 8 6 7 2 2 9 3 3 3 3 1 0
0 1 1 9 8 3 3 5 5 5 5 5 5 6 1 0
0 1 1 1 1 1 1 1 1 1 1 1 1 1 1 0
0 0 0 0 0 0 0 0 0 0 0 0 0 0 0 0
